0 0 1 0 0 0 5 5 5 5
0 1 2 2 0 2 1 1 1 5
0 5 2 2 1 1 0 2 1 5
0 5 5 5 1 0 0 1 0 0
0 0 1 2 0 1 0 5 5 2
0 0 0 1 1 1 0 1 5 5
3 4 3 3 3 4 4 3 4 4
6 6 6 6 6 6 6 6 6 6
6 7 7 6 6 7 7 7 7 6
7 7 7 7 7 7 7 7 7 7